merchandise	/'mə:tʃəndaiz,-dais/	n.商品,货物
merchant	/'mə:tʃənt/	n.商人,零售商
mercury	/'mə:kjuri/	n.水银,汞
mercy	/'mə:si/	n.仁慈,怜悯,宽恕
mere	/miə/	a.纯粹的;仅仅,只不过
merely	/'miəli/	adv.仅仅,只不过
merge	/mə:dʒ/	v.(使)结合,(使)合并,(使)合为一体
merit	/'merit/	n.优点,价值,功绩v.值得,应得
merry	/'meri/	a.欢乐的,愉快的
mess	/mes/	n.混乱,混杂,脏乱v.弄脏,弄乱,搞糟
message	/'mesidʒ/	n.消息,信息,通讯,启示,教训,广告词,预言
messenger	/'mesindʒə/	n.送信者,使者,传令兵
metal	/'metəl/	n.金属,金属制品
metaphor	/'metəfə/	n.隐喻,暗喻
method	/'meθəd/	n.方法,办法
metre	/'mi:tə/	n.(meter)米,公尺;仪表,计量器
metric	/'metrik/	a.米制的,公制的
metropolitan	/,metrə'pɔlitən/	a.首都的,主要都市的,大城市
microphone	/'maikrəfəun/	n.话筒,扩音器
microscope	/'maikrəskəup/	n.显微镜
middle	/'midl/	n./a.中间(的),当中(的)
midst	/midst/	n.中间,当中
might	/mait/	aux.v.可能,也许n.力量,威力,权力
migrate	/mai'ɡreit,'maiɡ-/	v.迁移,移居(国外)
mild	/maild/	a.温和的,轻微的,味淡的,不含有害物质的的
mile	/mail/	n.英里,哩,海里
militant	/'militənt/	a.好战的,富于战斗性的n.斗士
military	/'militəri/	a.军事的,军用的,军队的
milk	/milk/	n.牛奶;(植物流出的)白色乳液v.挤奶
mill	/mil/	n.磨粉机,磨坊;作坊,工厂
millimeter	/'mili,mi:tə/	n.(millimetre)毫米
million	/'miljən/	num./n.百万,百万个
millionaire	/,miljə'nεə/	n.百万富翁
mind	/maind/	n.精神,理智,意见,记忆力v.注意,介意,反对
mine	/main/	pron.(I的物主代词)我的(东西)n.矿v.采矿
mineral	/'minərəl/	n.矿物,矿石a.矿物的,矿质的
mingle	/'miŋɡl/	v.(使)混合
miniature	/'miniətʃə/	n.缩小的模型,缩图a.微型的,缩小的
minimize	/'minimaiz/	v.(minimize)使减少到最少,使降到最低
minimum	/'miniməm/	n.最小值,最低限度a.最小的,最低的
minister	/'ministə/	n.部长,大臣
ministry	/'ministri/	n.(政府的)部;牧师
minor	/'mainə/	a.较小的,较小的n.兼修学科v.(in)兼修
minority	/mai'nɔrəti,mi-/	n.少数,少数派,少数民族
minus	/'mainəs/	a.负的,减的prep.减去n.负号,减号
minute	/'minit/	n.分钟,片刻;(pl.)会议记录a.微小的
miracle	/'mirəkl/	n.奇迹,令人惊奇的人(或事)
mirror	/'mirə/	n.镜子;反映,反射v.反映,反射
mischief	/'mistʃif/	n.损害,伤害,危害;恶作剧,胡闹;灾祸
miserable	/'mizərəbl/	a.痛苦的,悲惨的
misery	/'mizəri/	n.痛苦,悲惨,不幸
misfortune	/mis'fɔ:tʃən/	n.不幸,灾祸,灾难
mislead	/,mis'li:d/	v.把…带错路,使误入岐途
miss	/mis/	n.小姐v.思念,未击中,错过,漏掉,逃脱
missile	/'misail,-səl/	n.导弹,发射物
missing	/'misiŋ/	a.漏掉的,失去的,失踪的
mission	/'miʃən/	n.使命,任务;使团,代表团
missionary	/'miʃənəri/	a.教会的,传教(士)的n.传教士
mist	/mist/	n.薄雾,霭
mistake	/mi'steik/	n.错误,过失,误解v.弄错;(for)把…误认为
mistress	/'mistris/	n.女主人;主妇;情妇,情人
misunderstand	/,misʌndə'stænd/	v.误解,误会
mix	/miks/	v.使混合;混淆
mixture	/'mikstʃə/	n.混合;混合物,混合剂
moan	/məun/	n.呻吟声,悲叹声v.呻吟,抱怨,悲叹
mob	/mɔb/	n.乌合之众(尤指暴力者)vi.围攻,聚众闹事
mobile	/'məubail/	a.可动的,活动的,运动的
mobilize	/'məubilaiz/	v.(mobilise)动员,赋予可动性
mock	/mɔk/	v.嘲笑a.假的,模拟的n.(常pl.)模拟考试
mode	/məud/	n.方式,式样
model	/'mɔdəl/	n.样式,型;模范;模型,原型;模特v.模仿
moderate	/'mɔdərət,'mɔdəreit/	a.有节制的,中等的,适度的,温和的,稳健的
modern	/'mɔdən/	a.现代的,近代的,新式的
modernization	/,mɔdənai'zeiʃən/	n.(modernisation)现代化
modest	/'mɔdist/	a.谦虚的,有节制的
modify	/'mɔdifai/	v.更改,修改,修饰
module	/'mɔdju:l,-dʒu:l/	n.组件,模块,模件;(航天器的)舱
moist	/mɔist/	a.潮湿的,湿润的,多雨的
moisture	/'mɔistʃə/	n.潮湿,湿气,湿度
molecule	/'mɔlikjul/	n.分子
moment	/'məumənt/	n.片刻,瞬间,时刻
momentum	/məu'mentəm/	n.动力,要素
monarch	/'mɔnək,-ɑ:k/	n.帝王,君主,最高统治者
Monday	/ˈmʌndeɪ,ˈmʌndi/	n.星期一
monetary	/'mʌnitəri/	a.金融的,货币的
money	/'mʌni/	n.货币,钱
monitor	/'mɔnitə/	n.班长;监听器,监视器v.监控,监测
monkey	/'mʌŋki/	n.猴子
monopoly	/mə'nɔpəli/	n.垄断,专卖,专利权,专利事业
monotonous	/mə'nɔtənəs/	a.单调的,无变化的
monster	/'mɔnstə/	n.怪物,妖怪,畸形的动植物
month	/mʌnθ/	n.月,月份
monthly	/'mʌnθli/	a.每月的ad.每月一次,按月n.月刊
monument	/'mɔnjumənt/	n.纪念碑,纪念馆,遗迹,不朽的业绩
mood	/mu:d/	n.心情,情绪;语气
moon	/mu:n/	n.(加the)月球,月亮;卫星
moral	/'mɔrəl,'mɔ:-/	a.道德(上)的,精神上的n.寓意,教育意义
morality	/mə'ræləti,mɔ:-/	n.道德,美德
more	/mɔ:/	a.更多的n.更多的人(或东西)ad.更,更多
moreover	/mɔ:'rəuvə/	conj./ad.再者,加之,而且
morning	/'mɔ:niŋ/	n.早晨,上午
mortal	/'mɔ:təl/	a.致命的;终有一死的;人世间的n.凡人
mortgage	/'mɔ:ɡidʒ/	n./v.抵押(借款)
mosaic	/məu'zeiik/	n.马赛克;镶嵌体
mosquito	/mə'ski:təu/	n.蚊子
moss	/mɔs/	n.苔,藓,地衣
most	/məust/	a.最多的;大多数的ad.最;极其n.大多数
mostly	/'məustli/	ad.几乎全部地;主要地,大部分,基本上
motel	/məu'tel/	n.(附有停车场的)汽车旅馆
mother	/'mʌðə/	n.母亲
motion	/'məuʃən/	n.运动,动;提议,动议v.提议,动议
motivate	/'məutiveit/	vt.促动;激励,鼓励,作为…的动机
motive	/'məutiv/	n.动机,目的a.发动的,运动的
motor	/'məutə/	n.发动机,电动机
mould	/məuld/	n.(mold)模子,铸型v.浇铸,造型,塑造
mount	/maunt/	v.登上;安装n.支架,底板;(用于山名前)山峰
mountain	/'mauntin/	n.山
mourn	/mɔ:n,məun/	v.哀悼,忧伤
mouse	/maus,mauz/	n.(pl.mice)鼠,耗子
mouth	/mauθ/	n.口,嘴
move	/mu:v/	v.移动,迁移;活动;感动n.移动,活动,行动
movement	/'mu:vmənt/	n.运动,活动;移动,迁移
movie	/'mu:vi/	n.电影,电影院
much	/mʌtʃ/	a.多的,大量的ad.十分,非常;到极大程度
mud	/mʌd/	n.泥,泥浆v.弄脏,使沾污泥
mug	/mʌɡ/	n.(有柄的)大茶杯
multiple	/'mʌltipl/	a.多样的,多重的n.倍数v.成倍增加
multiply	/'mʌltiplai/	v.(by)乘,使相乘;倍增,增加,繁殖
multitude	/'mʌlti,tju:d,-,tu:d/	n.众多,大量
municipal	/mju:'nisipəl/	a.市(立,政)的;地方性的,地方自治的
murder	/'mə:də/	v./n.谋杀,凶杀
murmur	/'mə:mə/	v./n.小声说(话);小声抱怨,咕哝
muscle	/'mʌsl/	n.肌肉,体力
muscular	/'mʌskjulə/	a.肌肉的;肌肉发达的;强健的
museum	/mju:'ziəm/	n.博物馆,展览馆
mushroom	/'mʌʃru:m,-rum/	n.蘑菇vt.迅速生长,迅速增加,采蘑菇
music	/'mju:zik/	n.音乐,乐曲,乐谱
musical	/'mju:zikəl/	a.音乐的;有音乐才能的n.音乐片
musician	/mju:'ziʃən/	n.音乐家,乐师
must	/mʌst/	aux.&v.必须;很可能;一定要n.必须做的事
mute	/mju:t/	a.哑的,缄默的n.哑巴;弱音器v.减弱…的声音
mutter	/'mʌtə/	n.喃喃而语,小声低语;抱怨v.低声说,抱怨
mutton	/'mʌtən/	n.羊肉
mutual	/'mju:tʃuəl,-tjuəl/	a.相互的,彼此的;共同的,共有的
my	/maɪ/	pron.(I的所有格)我的
myself	/mai'self/	pron./反身代词/我自己;我亲自
mysterious	/mi'stiəriəs/	a.神秘的,可疑的,难理解的
mystery	/'mistəri/	n.神秘,神秘的事物;神秘小说,侦探小说
myth	/miθ/	n.神话;虚构的理论
nail	/neil/	n.指甲,爪;钉v.将…钉牢,钉住
naive	/nɑ:'i:v,nai-/	a.天真的
naked	/'neikid/	a.裸体的,无遮敝的,无掩饰的
name	/neim/	n.名字(称/声/义)vt.给…取名;列举;提名
namely	/'neimli/	ad.即,也就是
nap	/næp/	n.小睡,打盹
napkin	/'næpkin/	n.餐巾,餐巾纸,<英>尿布
narrative	/'nærətiv/	a.叙述性的n.叙述
narrow	/'nærəu/	a.狭窄的,狭的,狭隘的
nasty	/'nɑ:sti,'næs-/	a.肮脏的,卑劣的,下流的;令人厌恶的
nation	/'neiʃən/	n.民族,国家
national	/'næʃənəl/	a.民族的,国家的,国立的
nationality	/,næʃən'æliti/	n.国籍,民族
native	/'neitiv/	a.本地的,本国的;天生的n.本地人,本国人
natural	/'nætʃərəl/	a.正常的;自然界的,天然的,天赋的,固有的
nature	/'neitʃə/	n.自然界,大自然;性质,本性,天性
naughty	/'nɔ:ti/	a.顽皮的,淘气的
naval	/'neivəl/	n.海军的,军舰的
navigation	/,nævi'ɡeiʃən/	n.航海,航空;导航,领航
navy	/'neivi/	n.海军
near	/niə/	a.近的,接近的;亲近的prep.靠近ad.接近
nearby	/'niə'bai/	a.附近的ad.在附近prep.在…附近
nearly	/'niəli/	ad.差不多,几乎
neat	/ni:t/	a.整洁的,干净的,优美的,精致的
necessary	/'nesisəri/	a.必需的,必要的;必然的n.必需品
necessitate	/ni'sesi,teit,nə-/	v.使成为必要,需要
necessity	/ni'sesəti,nə-/	n.必要性,需要;必然性;(pl.)必需品
neck	/nek/	n.颈脖
necklace	/'neklis/	n.项链,项圈
need	/ni:d/	aux.v./v.需要;必须n.需要;贫困,困窘
needle	/'ni:dl/	n.针,指针,针状物
negative	/'neɡətiv/	a.否定的,消极的,阴性的n.负数;(摄影)底片
neglect	/ni'ɡlekt/	v./n.忽视;疏忽,漏做,忽略
negligible	/'neɡlidʒəbl/	a.可忽略不计的,微不足道的
negotiate	/ni'ɡəuʃieit,-si-/	v.商订;谈判,洽谈,交涉
Negro	/ˈniːɡroʊ/	n.黑人a.黑人的
neighbor	/'neibə/	n.(neighbour)邻居
neighborhood	/'neibəhud/	n.(neighbourhood)邻居;四邻,街道
neither	/'naiðə,'ni:-/	a.两者都不pron.两者都不ad.也不
nephew	/'nefju:,'nev-/	n.侄子,外甥
nerve	/nə:v/	n.神经;勇敢,胆量
nervous	/'nə:vəs/	a.神经的;神经过敏的,紧张不安的
nest	/nest/	n.窝,巢v.筑巢
net	/net/	n.网,网状物v.用网捕,使落网a.纯净的
network	/'netwə:k/	n.网状物;广播网,电视网;网络
neutral	/'nju:trəl/	a.中立的;中性的,中和的
never	/'nevə/	ad.永不,从不,决不;从来没有;不,没有
nevertheless	/,nevəðə'les/	conj.(nonetheless)然而,不过ad.仍然,不过
new	/nju:,nu:/	a.新(近)的;新来的;不熟悉的;没经验的
news	/nju:z,nu:z/	n.新闻,消息;新闻报道,新闻广播
newspaper	/'nju:s,peipə,'nju:z-/	n.报纸
next	/nekst/	a.紧接的,其次的;贴近的ad.其次;居后
nice	/nais/	a.美好的,令人愉快的;友好的,亲切的
nickel	/'nikəl/	n.镍;镍币;五美分
nickname	/'nikneim/	n.绰号,浑名vt.给…起绰号
niece	/ni:s/	n.侄女,甥女
night	/nait/	n.夜间;夜;晚(上)
nightmare	/'naitmεə/	n.恶梦;可怕的事物,无法摆脱的恐惧
nine	/nain/	num.九pron./ad.九(个,只...)
nineteen	/,nain'ti:n/	num./a.十九pron.十九(个,只...)
ninety	/'nainti/	num.九十,九十个
nitrogen	/'naitrədʒən/	n./化/氮
no	/nəu/	ad.不是,不a.没有的;不允许n.不,拒绝
noble	/'nəubl/	a.高尚的;贵族的,高贵的n.贵族
nobody	/'nəubədi,-bɔdi/	pron.谁也不,无人n.小人物
nod	/nɔd/	v.点(头),点头招呼n.点头招呼;打盹,瞌睡
noise	/nɔiz/	n.喧闹声,噪声,吵嚷声
noisy	/'nɔizi/	a.吵闹的,喧闹的
nominal	/'nɔminəl/	a.名义上的;(金额,租金)微不足道的
nominate	/'nɔmineit/	v.提名,任命
none	/nʌn/	pron.没有任何人(东西);都不ad.一点也不
nonetheless	/ˌnʌnðəˈles/	ad.虽然如此,但是
nonsense	/'nɔnsəns/	n.胡说,废话
noodle	/'nu:dl/	n.(常用复数)面条
noon	/nu:n/	n.中午,正午
nor	/nɔ:,弱nə/	conj.／ad.也不,也没有
norm	/nɔ:m/	n.准则,规范,准则,平均数
normal	/'nɔ:məl/	a.正常的,普通的;正规的,标准的
normalization	/,nɔ:məlai'zeiʃən/	n.(normalisation)正常化,标准化
north	/nɔ:θ/	n.北,北方a.北方的,北部ad.向北方,在北方
northeast	/,nɔ:θ'i:st/	n.东北a.东北方的ad.向东北,在东北
northern	/ˈnɔːrðərn/	a.北方的,北部的
northwest	/,nɔ:θ'west/	n.西北方,西北部a.西北的ad.向西北,在西北
nose	/nəuz/	n.鼻子;(飞机,船等的)前端,突出部分
not	/nɔt/	ad.不,不是,不会;没有
notable	/'nəutəbl/	n.值得注意的,显著的,著名的
note	/nəut/	n.笔记;按语,注释;钞票,纸币v.记下,摘下
notebook	/'nəutbuk/	n.笔记本
nothing	/'nʌθiŋ/	n.没有东西;什么也没有;无关紧要的人或事
notice	/'nəutis/	n.通知,通告,布告;注意,认识v.注意到,注意
noticeable	/'nəutisəbl/	a.显而易见的,值得注意的,重要的
notify	/'nəutifai/	v.通知,告知,报告
notion	/'nəuʃən/	n.概念,想法,意念,看法,观点
notorious	/nəu'tɔ:riəs/	a.臭名昭著的,声名狼藉的
notwithstanding	/,nɔtwiθ'stændiŋ/	prep./ad./conj.尽管
noun	/naun/	n.名词
nourish	/'nʌriʃ,'nə:-/	v.提供养分,养育,怀有(希望,仇恨等)
novel	/'nɔvəl/	n.(长篇)小说a.新奇的,新颖的
novelty	/'nɔvəlti/	n.新奇,新颖,新奇的事物
November	/noʊˈvembər/	n.十一月
now	/nau/	ad.现在,如今,目前;当时,于是,然后
nowadays	/'nauədeiz/	ad.现今,现在
nowhere	/'nəuhwεə/	ad.任何地方都不,没有地方
nuclear	/'nju:kliə,'nu:-/	a.核心的,中心的;原子核的,核能的
nucleus	/'nju:kliəs/	n.(pl.nuclei)核,核心,原子核
nuisance	/'nju:səns/	n.讨厌的人(或东西);麻烦事
numb	/nʌm/	a.麻木的,失去感觉的v.使麻木
number	/'nʌmbə/	n.数,数字,数量,号码,一群v.共计,编号
numerical	/nju:'merikəl/	a.数字的,用数字表示的,数值的
numerous	/'nju:mərəs/	a.众多的,许多的,大批的
nurse	/nə:s/	n.护士,保姆v.护理,看护
nursery	/'nə:səri/	n.托儿所
nurture	/'nə:tʃə/	n./v.养育,教育,教养n.营养品v.给与营养物
nut	/nʌt/	n.坚果;螺母,螺帽
nutrition	/nju:'triʃən/	n.营养,营养学
nylon	/'nailɔn/	n.尼龙
oak	/əuk/	n.橡树,橡木a.橡木的
oar	/ɔ:,əu/	n.桨,橹v.划,划动,划行
oath	/əuθ/	n.誓言,誓约,诅咒
obedience	/əu'bi:diəns/	n.服从,顺从
obedient	/əu'bi:diənt/	a.服从的,顺从的
obey	/əu'bei/	v.服从,顺从
object	/'ɔbdʒikt/	n.物体;客体,对象;目标;宾语v.(to)反对
objection	/əb'dʒekʃən,ɔb-/	n.(to)反对,异议,不喜欢,反对的理由
objective	/əb'dʒektiv,ɔb-/	n.目标,目的a.客观的,真实的
obligation	/,ɔbli'ɡeiʃən/	n.义务,责任
oblige	/ə'blaidʒ/	v.强迫,迫使;责成;(使)感激,施恩于
obscure	/əb'skjuə,ɔb-/	a.暗的,朦胧的;模糊的,晦涩的
observation	/,ɔbzə:'veiʃən/	n.观察,观测,监视;(pl.)观察资料;观察力
observe	/əb'zə:v/	v.观察,观测,注意到,监视,遵守,评述,说
obsession	/əb'seʃən,ɔb-/	n.迷住,困扰
obsolete	/'ɔbsəli:t,,ɔbsə'li:t/	a.已废弃的,过时的
obstacle	/'ɔbstəkl/	n.障碍(物),妨碍,阻碍,干扰
obstruct	/əb'strʌkt,ɔb-/	v.阻隔,阻塞(道路、通道等)n.阻碍物,障碍物
obstruction	/əb'strʌkʃən,ɔb-/	n.妨碍,障碍物
obtain	/əb'tein,ɔb-/	v.获得,得到
obvious	/'ɔbviəs/	a.明显的,显而易见的
occasion	/ə'keiʒən,əu-/	n.场合,时节,时刻;时机,机会
occasional	/ə'keiʒənəl,əu-/	a.偶然的,非经常的,特殊场合的;临时的
occupation	/,ɔkju'peiʃən/	n.占领,占据;占用;职业,工作
occupy	/'ɔkjupai/	v.占,占用;占据,占领;使忙碌,使从事
occur	/ə'kə:/	v.发生,出现;存在;想起,想到
occurrence	/ə'kə:rəns,-'kʌ-/	n.发生,出现;事件,事故,发生的事情
ocean	/'əuʃən/	n.海洋
o'clock	/ə'klɔk,əu-/	ad.(…)点钟(与1至12数字连用)
October	/ɑːkˈtoʊbər/	n.十月
odd	/ɔd/	a.奇数的;奇怪的;单只的;临时的;带零头的
odds	/ɔdz/	n.不平等,差异;机会
odor	/'əudə/	n.(odour)气味,香味,臭味,名声
of	/ɔv,əv,v,f/	prep.…的;在…之中;用…制的;关于…的
off	/ɔ:f,ɔf/	ad.离开;在远处;脱开prep.从,从...离开
offend	/ə'fend/	v.犯罪,冒犯,违反,得罪,使...不愉快
offensive	/ə'fensiv/	a.冒犯的,攻击的n.攻势,进攻
offer	/'ɔfə,'ɔ:-/	v.提供,提议,出现n.出价,提议,意图
office	/'ɔfis,'ɔ:-/	n.办公室,办事处;职务,公职;部,局,处
officer	/'ɔfisə,'ɔ:-/	n.官员,办事员;工作人员;军官
official	/ə'fiʃəl,əu-/	n.官员,行政官员a.官方的,官方的,正式的
offset	/,ɔf'set,'ɔfset,'ɔ:-/	n.分支,补偿v.抵消,补偿
offspring	/'ɔfspriŋ,'ɔ:-/	n.子孙,后代;结果,产物
often	/'ɔfən,'ɔftən,'ɔ:-/	ad.常常,经常,通常
oil	/ɔil/	n.油,石油v.给…加润滑油;涂油,上油
okay	/,o'kɛi/	a.(okey,OK,O.K.)好,行,不错n.同意
old	/əuld/	a.年老的;…岁的;长时间的,老的;过去的
omit	/əu'mit/	v.省略,删去;遗漏,忽略
on	/ɔn,ɔ:n,ən,n/	a.连接上prep.在…上;靠近ad.向前,继续
once	/wʌns/	ad.一次,曾经conj.一(旦)…就…n.一次
one	/wʌn/	num.一pron.一个(只)(表示代替可数的东西)
oneself	/wʌn'self,-zelf/	pron./反身代词/自己;亲自,本人
onion	/'ʌnjən/	n.洋葱
only	/'əunli/	ad.仅仅,只不过a.唯一的conj.可是,不过
onto	/'ɔntu,-tə/	prep.在...上面;到...上面
opaque	/əu'peik/	a.不透明(光)的;难理解的,晦涩的
open	/'əupən/	n.公开,户外a.开的,开放的v.开
opening	/'əupəniŋ/	n.开,开放,开始,空缺,机会a.开始的,开幕的
opera	/'ɔpərə/	n.歌剧
operate	/'ɔpəreit/	v.操作,运转,开动,起作用,动手术
operation	/,ɔpə'reiʃən/	n.运转,开动,操作,手术,运算,经营
operational	/,ɔpə'reiʃənəl/	a.操作的,运转的,起作用的,经营的
operator	/'ɔpəreitə/	n.操作人员,(电话)接线员
opinion	/ə'pinjən/	n.意见,看法,主张
opponent	/ə'pəunənt/	n.对手,反对者,敌手a.对立的,对抗的
opportunity	/,ɔpə'tju:niti/	n.机会
oppose	/ə'pəuz/	v.反对,使对立,使对抗,使相对
opposite	/'ɔpəzit,-sit/	a.对面的,相对的,相反的n.对立面
oppress	/ə'pres/	v.压迫,压制
opt	/ɔpt/	vi.抉择,选择
optical	/'ɔptikəl/	a.眼的,视力的;光学的
optimistic	/,ɔpti'mistik/	a.乐观主义的
optimum	/'ɔptiməm/	a.最适宜的n.最适宜(条件)
option	/'ɔpʃən/	n.选择(权),/商/选择买卖的特权
optional	/'ɔpʃənəl/	a.可以任选的,随意的,非强制的
or	/ɔ:,ə/	conj.或,或者(表示选择);即,大约;否则
oral	/'ɔ:rəl,'ɔ-/	a.口头的
orange	/'ɔrindʒ,'ɔ:-/	n.柑,桔,橙
orbit	/'ɔ:bit/	n.轨道v.(使)沿轨道行
orchard	/'ɔ:tʃəd/	n.果园,果园里的全部果树,<美俚>棒球场
orchestra	/'ɔ:kistrə,-kes-/	n.管弦乐队
order	/'ɔ:də/	n.命令;次序;整齐;定货单;等级v.定制,订购
orderly	/'ɔ:dəli/	a.整齐的,有秩序的,有条理的n.勤务兵
ordinary	/'ɔ:dinəri,-neri-/	a.普通的,平凡的,平常的;平庸的
ore	/ɔ:/	n.矿石,矿砂
organ	/'ɔ:ɡən/	n.器官;机构,机关;风琴
organic	/ɔ:'ɡænik/	a.器官的;有机的;有机体的
organism	/'ɔ:ɡənizəm/	n.生物,有机体
organization	/,ɔ:ɡənai'zeiʃən,-ni'z-/	n.(organization)组织,团体,机构
organize	/'ɔ:ɡənaiz/	v.(organise)组织,编组
orient	/'ɔ:riənt,'əu-,'ɔ:rient/	n.东方,亚洲v.使朝东,为…定位,使适应
oriental	/ˌɔːriˈentl/	a.东方的,东方诸国的n.东方人
orientation	/,ɔ:rien'teiʃən,əu-/	n.方向,方位,定位,倾向性,向东方
origin	/'ɔridʒin,'ɔ:-/	n.起源,由来;出身,来历
original	/ə'ridʒənəl/	a.最初的,原文的;新颖的n.原物,原作,原文
originate	/ə'ridʒəneit/	v.(in,from)起源,发生;首创,创造
ornament	/'ɔ:nəmənt,'ɔ:nəment/	v.装饰,美化n.装饰,装饰物
orphan	/'ɔ:fən/	n.孤儿
orthodox	/'ɔ:θədɔks/	a.传统的,正统的,习惯的,保守的,东正教的
other	/'ʌðə/	a.另外的,其他的n./pron.另一个人(或事)
otherwise	/'ʌðəwaiz/	ad.另样,用别的方法;在其他方面conj.要不然
ought	/ɔ:t/	aux.应该(使用时,之后应接to,再接动词原形)
ounce	/auns/	n.盎司,英两
our	/'auə,ɑ:/	pron./we的所有格/我们的
ours	/'auəz,弱ɑ:z/	pron./we的物主代词/我们的(所有物)
ourselves	/,auə'selvz,,ɑ:-/	pron./反身代词/我们自己;我们亲自
out	/aut/	ad.出去;离家;突出来a.外面的,往外去的
outbreak	/'autbreik,,aut'breik/	n.(战争,愤怒,火灾等的)爆发,(疾病的)发作
outcome	/'autkʌm/	n.结果,成果
outdoor	/'əutdɔ:/	a.室外的,野外的
outer	/'autə/	a.外部的,外面的,外层的
outfit	/'autfit/	n.用具,机构,全套装配v.配备,(得到)装备
outing	/'autiŋ/	n.外出,旅行,散步
outlet	/'autlet,-lit/	n.出路,出口;销路,市场;发泄方法;电源插座
outline	/'autlain/	n.轮廓,略图;大纲,梗概v.概述,略述
outlook	/'autluk,,aut'luk/	n.景色,风光;观点,见解;展望,前景
output	/'autput,,aut'put/	n.产量,输出(量)
outrage	/'autreidʒ/	n.暴行,侮辱,愤怒v.凌辱,引起…义愤,强奸
outset	/'autset/	n.开始,开端
outside	/,aut'said,'aut'said/	ad.向外面n.外部a.外部的prep.在…外
outskirts	/ˈaʊtskɜːrts/	n.郊区
outstanding	/,aut'stændiŋ/	a.突出的,显著的,杰出的
outward	/'autwəd/	a.外面的,公开的,向外的ad.向外,在外n.外表
oval	/'əuvəl/	a.卵形的,椭圆形的n.卵形,椭圆形
oven	/'ʌvən/	n.炉,灶,灶箱
over	/'əuvə/	ad.在上方;遍及地prep.在的上方a.结束的
overall	/'əuvərɔ:l,,əuvə'rɔ:l/	a.全面的,综合的n.(pl.)(套头)工作服
overcoat	/'əuvəkəut/	n.外衣,大衣
overcome	/,əuvə'kʌm/	v.战胜,克服
overflow	/,əuvə'fləu,'əuvəfləu/	v.(使)外溢,(使)溢出;溢出,流出,漫出
overhead	/'əuvəhed,,əuvə'hed/	a.在头顶上的;架空的ad.在头顶上
overhear	/,əuvə'hiə/	v.偶然听到,从旁听到
overlap	/,əuvə'læp,'əuvəlæp/	v.重叠,与…交叠n.重叠
overlook	/,əuvə'luk,'əuvəluk/	v.看漏,忽略;俯瞰,眺望;宽容,放任
overnight	/,əuvə'nait,'əuvənait/	a.通宵的,晚上的ad.在昨夜,一夜工夫,突然
overpass	/'əuvəpɑ:s,-pæs/	n.过街天桥vt.胜过,通过,忽视
overseas	/'əuvə'si:z/	a.外国的,海外的ad.在海外
overtake	/,əuvə'teik/	v.追上,超过,突然降临,压倒
overthrow	/,əuvə'θrəu/	v./n.推翻,颠覆
overtime	/'əuvətaim/	a.超时的,加班的ad.加班
overturn	/,əuvə'tə:n,'əuvətə:n/	n.倾覆,破灭,革命v.打翻,推翻,颠倒,翻倒
overwhelm	/,əuvə'hwelm/	v.淹没,覆没,压倒,制服,使不知所措
overwhelming	/,əuvə'hwelmiŋ/	a.势不可挡的,压倒的
owe	/əu/	v.欠(债等),应向…付出,归功于,得感谢
owing	/'əuiŋ/	a.欠的,未付的
owl	/aul/	n.猫头鹰
own	/əun/	a.(用在所有格后面,加强语气)自己的
owner	/'əunə/	n.物主,所有者
ownership	/'əunəʃip/	n.所有(权),所有制
ox	/ɔks/	n.牛,公牛
oxide	/ˈɑːksaɪd/	n./化/氧化物
oxygen	/'ɔksidʒən/	n.氧,氧气
ozone	/'əuzəun/	n.臭氧;(海岸等的)新鲜空气
pace	/peis,'peisi/	n.步,步伐,步调,速度v.踱步,用步测
pack	/pæk/	v.捆扎,打包;塞满,挤满n.包裹,背包,一群/副
package	/'pækidʒ/	n.包装,包裹,箱,包装费,标准部件,成套设备
packet	/'pækit/	n.小包裹,小捆;盒;一捆,一扎;邮船,班轮
pact	/pækt/	n.合同,条约,公约,协定
pad	/pæd/	n.垫,衬垫;便笺簿v.加上衬垫
paddle	/'pædl/	n.桨v.用桨划
page	/peidʒ/	n.页,记录,事件,专栏vt.给...标页码
pail	/peil/	n.桶,提桶;一桶的量
pain	/pein/	n.痛,痛苦;(pl.)努力,劳苦vt.使痛苦
painful	/'peinfl/	a.疼痛的,使痛苦的,费力/心/的,棘手的
paint	/peint/	n.油漆,颜料v.油漆;涂,涂漆;画;描绘,描述
painter	/'peintə/	n.漆工,画家
painting	/'peintiŋ/	n.上油漆,着色;绘画;油画;画法
pair	/pεə/	n.一对,一双;一副;夫妇v.配对,成对
palace	/'pælis/	n.宫,宫殿
pale	/peil/	a.苍白的,灰白的;浅的,暗淡的
palm	/pɑ:m/	n.手掌,掌状物,棕榈vt.与…握手,藏…于掌中
pamphlet	/'pæmflit/	n.小册子
pan	/pæn/	n.平底锅,盘子,面板
panda	/'pændə/	n.熊猫
panel	/'pænl/	n.面,板;控制板,仪表盘;专门小组
panic	/'pænik/	n./a.恐慌(的),惊慌(的)vt.使惊慌,使害怕
panorama	/,pænə'rɑ:mə/	n.全景,全景画,全景摄影,全景照片/装置/
pant	/pænt/	n.喘气v.喘,气喘吁吁地说
pants	/pænts/	n.裤子,短裤
paper	/'peipə/	n.纸;纸制品;报纸;(pl)文件;试卷;论文
paperback	/'peipəbæk/	n.平装本,简装本
parachute	/'pærə,ʃu:t/	n.降落伞v.跳伞
parade	/pə'reid/	n./v.游行,夸耀n.检阅,阅兵式v.使列队行进
paradigm	/'pærədim/	n.典范;范例;示例
paradox	/'pærədɔks/	n.似非而是的话,自相矛盾的话,反论
paragraph	/'pærəɡrɑ:f,-ɡræf/	n.段,节;小新闻,短评
parallel	/'pærəlel/	a.平行的,相同的,类似的n.平行线,类似,对比
paralyze	/'pærəlaiz/	v.(paralyse)使瘫痪(麻痹);使丧失作用
parameter	/pə'ræmitə/	n.参数,参量
parasite	/'pærəsait/	n.寄生虫,食客
parcel	/'pɑ:sl/	n.包裹,邮包,部分v.打包,捆扎,分配
pardon	/'pɑ:dn/	n.原谅,宽恕;请再说一遍v.原谅,饶恕,赦免
parent	/'pεərənt/	n.父母,母亲;(pl.)双亲;父母
park	/pɑ:k/	n.公园,停车场,运动场v.停放(汽车等),寄放
parliament	/'pɑ:ləmənt/	n.国会,议会
part	/pɑ:t/	n.部分,角色,一方,零件,地区,部,篇v.使分开
partial	/'pɑ:ʃəl/	a.部分的,不完全的;偏袒的,不公平的,偏爱的
participant	/pɑ:'tisipənt/	n.参加者,参与者a.有份的,参与的
participate	/pɑ:'tisipeit/	v.(in)参与,参加;分享,分担;含有,带有
particle	/'pɑ:tikl/	n.粒子,微粒;极小量;小品词,虚词
particular	/pə'tikjulə/	a.特殊的,苛求的,个别的n.详情,细节,特色
partly	/'pɑ:tli/	ad.部分地,不完全地,在一定程度上
partner	/'pɑ:tnə/	n.合作者,合伙人,合股人,伙伴,舞伴,配偶
party	/'pɑ:ti/	n.聚会,政党,当事人v.举行(参加)社交聚会
pass	/pɑ:s,pæs/	v.经/通/穿/度过;传递n.通行证;考试及格
passage	/'pəsidʒ/	n.通过,经过;通路,走廊;(一)段落,(一)节
passenger	/'pæsindʒə/	n.乘客,旅客
passer-by	/ˌpɑːsə ˈbaɪ/	n.(pl.passers-by)过路人
passion	/'pæʃən/	n.热情,激情,爱好;激怒;强烈感情
passive	/'pæsiv/	a.被动的,消极的
passport	/'pɑ:spɔ:t,'pæs-/	n.护照,达到某种目的的手段
past	/pɑ:st,pæst/	a.过去的ad.过n.过去,昔日prep.(经)过
paste	/peist/	n.糊,浆糊v.粘,贴
pastime	/'pɑ:staim/	n.消遣,娱乐
pasture	/'pɑ:stʃə,'pæs-/	n.牧草地,牧场
pat	/pæt/	v./n.轻拍,轻打,抚摸
patch	/pætʃ/	n.补丁,斑点,碎片小块v.补,修补,掩饰
patent	/'peitənt/	a.专利的,特许的n.专利(权、品)v.批准专利
path	/pɑ:θ,pæθ/	n.小路,小径;路线,轨道
pathetic	/pə'θetik/	a.可怜的,悲惨的
patience	/'peiʃəns/	n.耐心,忍耐
patient	/'peiʃənt/	a.有耐心的,能忍耐的n.病人,患者
patriotic	/,pætri'ɔtik/	a.爱国的
patrol	/pə'trəul/	v.巡逻,巡查n.巡逻,巡查;巡逻队
patron	/'peitrən/	n.赞助人;资助人;老顾客,老主顾
pattern	/'pætən/	n.模式,式样;图案,图样v.仿制,模仿
pause	/pɔ:z/	v./n.中止,暂停
pave	/peiv/	v.铺砌,铺(路)
pavement	/'peivmənt/	n.人行道
paw	/pɔ:/	n.爪
pay	/pei/	v.付款,付出代价,给予注意n.工资,薪金
payment	/'peimənt/	n.支付,付款额
pea	/pi:/	n.豌豆
peace	/pi:s/	n.和平;平静,安宁
peaceful	/'pi:sful/	a.和平的,平静的,安宁的,爱好和平的
peach	/pi:tʃ/	n.桃,桃树
peak	/pi:k/	n.山顶,最高点;峰,山峰a.高峰的,最高的
peanut	/'pi:nʌt/	n.花生
pear	/pεə/	n.梨子,梨树
pearl	/pə:l/	n.珍珠
peasant	/'pezənt/	n.(不用于英国或美国)小农;佃农;农民
pebble	/'pebl/	n.卵石
peculiar	/pi'kju:ljə/	a.古怪的,异常的;特殊的,特有的
pedal	/'pedl/	n.踏板v.踩踏板,骑自行车
pedestrian	/pi'destriən/	n.步行者a.徒步的,呆板的,通俗的
peel	/pi:l/	v.削皮,剥皮n.果皮
peep	/pi:p/	v.偷看,窥视
peer	/piə/	n.同辈,同等地位的人;贵族v.凝视,隐约出现
pen	/pen/	n.钢笔,圆珠笔,作家,围栏vt.写,关入栏中
penalty	/'penəlti/	n.处罚,刑罚,惩罚,罚金
pencil	/'pensəl/	n.铅笔vt.用铅笔写
pendulum	/'pendjuləm,-dʒə-/	n.摆,钟摆
penetrate	/'penitreit/	v.穿过,渗入,看穿
peninsula	/pi'ninsjulə/	n.半岛
penny	/'peni/	n.便士,美分
pension	/'penʃən/	n.养老金,抚恤金
people	/'pi:pl/	n.人们,人;/the-/人民;一国人民,民族
pepper	/'pepə/	n.胡椒粉,胡椒;辣椒
per	/强pə:,弱pə/	prep.每;经,由
perceive	/pə'si:v/	v.察觉,感知;理解,领悟
percent	/pə'sent/	n.(percent)百分之...的
percentage	/pə'sentidʒ/	n.百分数,百分率,百分比
perfect	/'pə:fikt,pə'fekt/	a.完善的;完全的;(语法)完成的v.使完美
perfection	/pə'fekʃən/	n.尽善尽美,完美
perform	/pə'fɔ:m/	v.履行,执行;表演,演出;完成(事业)
performance	/pə'fɔ:məns/	n.履行,执行;表演,演出;性能,特性;成绩
perfume	/pə'fju:m/	n.香味,芳香;香料v.使发香,洒香水于
perhaps	/pə'hæps,præps/	ad.也许,大概,恐怕
period	/'piəriəd/	n.时期,时代;学时;周期,一段时间;句点
periodical	/,piəri'ɔdikəl/	n.期刊,杂志a.周期的,定期的
perish	/'periʃ/	v.丧生;凋谢;毁灭,消亡
permanent	/'pə:mənənt/	a.永久的,持久的
permeate	/'pə:mieit/	v.弥漫,遍布,散布;渗入,渗透
permission	/pə'miʃən/	n.允许,同意
permit	/pə'mit/	v.许可,允许n.许可证,执照
perpetual	/pə'petʃuəl,-tju-/	a.永久的,永恒的,长期的
perplex	/pə'pleks/	v.使困惑,使费解,使复杂化
persecute	/'pə:sikju:t/	v.迫害
persevere	/,pə:si'viə/	v.坚持,坚忍,不屈不挠
persist	/pə'sist,-'zist/	v.(in)坚持,持续
person	/'pə:sən/	n.人,喜欢(或适应)..的人;人物;人称
personal	/'pə:sənl/	a.个人的,私人的;亲自的;身体的,人身的
personality	/,pə:sə'næləti/	n.人格,个性
personnel	/,pə:sə'nel/	n.全体人员,全体职员;人事(部门)
perspective	/pə'spektiv/	n.透视画法,透视图;远景,前途;观点,看法
persuade	/pə'sweid/	v.说服,劝说;(of)使相信
persuasion	/pə'sweiʒən/	n.说服,说服力
pessimistic	/,pesi'mistik/	a.悲观(主义)的
pest	/pest/	n.害虫
pet	/pet/	n.爱畜,宠儿a.宠爱的,表示亲昵的
petition	/pi'tiʃən/	n.请愿书,申请书v.(向…)请愿,正式请求
petrol	/'petrəl/	n.汽油
petroleum	/pi'trəuliəm,pə-/	n.石油
petty	/'peti/	a.小(器、规模)的,不重要的,细微的,卑鄙的
pharmacy	/'fɑ:məsi/	n.药房,药剂学,制药业,配药业,一批备用药品
phase	/feiz/	n.阶段,状态,时期;相,相位
phenomenon	/fi'nɔminən,fə-/	n.现象,稀有现象,珍品,奇迹,杰出人才
philosopher	/fi'lɔsəfə,fə-/	n.哲学家,哲人
philosophy	/fi'lɔsəfi,fə-/	n.哲学,哲理,人生观,价值观,世界观
phone	/fəun/	n.(telephone)电话,电话机,耳机v.打电话
photo	/'fəutəu/	n.(photograph)照片
phrase	/freiz/	n.短语,词语,习语
physical	/'fizikəl/	a.物质的;肉体的,身体的;自然科学的,物理的
physician	/fi'ziʃən/	n.内科医生
physicist	/'fizisist/	n.物理学家
physics	/'fiziks/	n.物理(学)
physiological	/,fiziə'lɔdʒikəl/	a.生理学的,生理学上的
piano	/pi'ænəu,pi'ɑ:-/	n.钢琴
pick	/pik/	v.拾,采,摘;挑选,选择n.镐,鹤嘴锄
pickup	/'pikʌp/	n.拾起,获得
picnic	/'piknik/	n.野餐v.(去)野餐
picture	/'piktʃə/	n.画,图片;影片;美景v.画,描述,想象
pie	/pai/	n.馅饼
piece	/pi:s/	n.(一)件/片/篇;碎片v.(together)拼合,拼凑
pierce	/piəs/	v.剌穿,刺破
pig	/piɡ/	n.猪,猪肉;猪一般的人(指肮脏,贪吃的人)
pigeon	/'pidʒin/	n.鸽
pile	/pail/	n.堆,大量,大数目v.(up)堆,叠,堆积
pilgrim	/'pilɡrim/	n.(在国外)旅游者;朝圣者,最初的移民
pill	/pil/	n.药丸
pillar	/'pilə/	n.柱,台柱,栋梁
pillow	/'piləu/	n.枕头
pilot	/'pailət/	n.飞行员;领港员v.驾驶(飞机等);领航,引水
pin	/pin/	n.钉;大头针,别针,徽章v.(up)钉住,别住
pinch	/pintʃ/	v.捏,掐,拧;收缩;紧急关头;匮乏;压力
pine	/pain/	n.松树
pink	/piŋk/	n.粉红色a.粉红色的
pint	/paint/	n.品脱
pioneer	/,paiə'niə/	n.先驱,倡导者,开拓者
pipe	/paip/	n.管子,导管;烟斗;笛
pirate	/'paiərit/	n./v.海盗,盗版(者)
pistol	/'pistl/	n.手枪
piston	/'pistən/	n.活塞
pit	/pit/	n.坑,陷阱;煤矿,矿井
pitch	/pitʃ/	n.沥青;掷v.用沥青覆盖;投掷,扔
pity	/'piti/	v.(觉得)可怜,惋惜n.憾事,怜悯
place	/pleis/	n.地方;名次;地位;寓所v.安排;放置;投(资)
plague	/pleiɡ/	n.瘟疫,灾害,麻烦,苦恼vt.折磨,使苦恼
plain	/plein/	a.明白的;朴素的;坦率;平凡n.平原,旷野
plan	/plæn/	n.计划,规划;平面图,设计图v.计划
plane	/plein/	n.飞机;平面,水平面
planet	/'plænit/	n.行星
plant	/plɑ:nt,plænt/	n.植物,作物;工厂;装置v.栽种,播种,栽培
plantation	/plæn'teiʃən/	n.种植园
plaster	/'plɑ:stə,'plæs-/	n.灰泥;熟石膏;膏药
plastic	/'plæstik,'plɑ:s-/	n.(常pl.)塑料,塑料制品a.可塑的,塑性的
plate	/pleit/	n.金属板,片;盘子,盆子;板,钢板v.镀,电镀
plateau	/'plætəu,plæ't-/	n.高原,平稳状态/时期/
platform	/'plætfɔ:m/	n.平台,台;站台,月台;政纲,党纲
plausible	/'plɔ:zəble/	a.似是而非的,似乎合理的,似乎可信的
play	/plei/	v.玩,做游戏;参加比赛n.游戏;玩耍;剧本
playground	/'pleiɡraund/	n.运动场,游戏场
plea	/pli:/	n.(法律)抗辩;请求,恳求,托词,口实
plead	/pli:d/	v.恳求,请求;为…辩护;提出…为理由
pleasant	/'plezənt/	a.令人愉快的vt.使高兴vi.满意;喜欢
please	/pli:z/	v.请;使愉快,使满意;喜欢,愿意
pleasure	/'pleʒə,'plei-/	n.愉快,快乐;乐事,乐趣
pledge	/pledʒ/	n.誓约;保证v.发誓;保证
plentiful	/'plentiful/	a.富裕的,丰富的
plenty	/'plenti/	n.丰富,大量
plight	/plait/	n.情况,状态,困境,盟誓(婚姻)v.保证,约定
plot	/plɔt/	n.秘密计划;情节v.标绘,绘制;密谋,策划
plough	/plau/	n.(plow)犁,耕地,犁过的地v.犁,费力地前进
plug	/plʌɡ/	n.塞子,插头v.堵,塞,插上,插栓
plumber	/'plʌmə/	n.(装修水管的)管子工
plunge	/plʌndʒ/	v.(into)(使)投入,(使)插进,陷入;猛冲
plural	/'pluərəl/	a.复数的n.复数
plus	/plʌs/	prep.加上a.正的,加的n.加号,正号
pneumonia	/nju:'məunjə/	n.肺炎
pocket	/'pɔkit/	n.衣袋a.袖珍的,小型的v.把…装入袋内
poem	/'pəuim/	n.诗
poet	/'pəuit/	n.诗人
poetry	/'pəuitri/	n.诗歌,诗集
point	/pɔint/	n.尖;点;条款;分数,得分;论点v.(at,to)指
poison	/'pɔizən/	n.毒物,毒药v.放毒,毒害,污染
poisonous	/'pɔizənəs/	a.有毒的,恶意的,恶毒的,道德败坏的
poke	/pəuk/	n.刺,戳,懒汉,袋子v.戳,刺,伸出,刺探,闲荡
polar	/'pəulə/	a.两极的,极地的,南辕北辙的n.极线,极面
pole	/pəul/	n.柱,杆;地极,磁极,电极
police	/pə'li:s/	n.警察,警察机关a.警察的v.管辖
policeman	/pə'li:smən/	n.警察
policy	/'pɔlisi/	n.政策,方针
polish	/'pɔliʃ/	v.磨光,擦亮;使优美,润饰n.擦光剂,上光蜡
polite	/'pə:lait/	a.有礼貌的,客气的;有教养的,文雅的
political	/pə'litikəl/	a.政治的
politician	/,pɔli'tiʃən/	n.政治家,政客
politics	/'pɔlitiks/	n.政治,政治学;政纲,政见
poll	/pəul/	n.民意测验;(pl.)政治选举v.获得…选票
pollute	/pə'lju:t/	v.弄脏,污染
pollution	/pə:'lju:ʃən/	n.污染
pond	/pɔnd/	n.池塘
ponder	/'pɔndə/	v.沉思,考虑
pool	/pu:l/	n.水池,游泳池;合资经营v.合伙经营,联营
poor	/puə,pɔ:/	a.贫困的;可怜的;贫乏的;贫瘠的;低劣的
pop	/pɔp/	a.流行的n.(发出)砰的一声v.突然出现
pope	/pəup/	n.罗马教皇,主教,大腿上要害部位
popular	/'pɔpjulə/	a.流行的,通俗的,大众的;广受欢迎的
population	/,pɔpju'leiʃən/	n.人口,(全体)居民
porcelain	/'pɔ:səlin,-lein/	n.瓷器a.精制的,瓷器的
porch	/pɔ:tʃ/	n.门廊,入口处
pork	/pɔ:k/	n.猪肉
port	/pɔ:t,pəut/	n.港口
portable	/'pɔ:təbl,'pəu-/	a.轻便的,手提(式)的,可移动的
porter	/'pɔ:tə,'pəu-/	n.守门人,门房,行李搬运工,服务员
portion	/'pɔ:ʃən,'pəu-/	n.一部分,一份
portrait	/'pɔ:trit,-treit,'pəu-/	n.肖像,画像
portray	/pɔ:'trei,pəu-/	v.描写,描述;画(人物、景象等)
pose	/pəuz/	n.姿势,姿态v.造成,提出,摆姿势,佯装
position	/pə'ziʃən/	n.位置;职位;姿势,姿态;见解,立场,形势
positive	/'pɔzətiv,-zi-/	a.肯定的,积极的,绝对的,无疑的,正的
possess	/pə'zes/	v.占有,拥有
possession	/pə'zeʃən/	n.持有,拥有;所有权;所有物;(pl.)财产,财富
possibility	/,pɔsə'biləti/	n.可能,可能性;可能的事,希望
possible	/'pɔsəbl/	a.可能的,做得到的;合理的;可允许的
possibly	/'pɔsəbli/	ad.可能地,也许;无论如何
post	/pəust/	v.贴出;公告;投寄n.(支)柱;邮政,邮寄;职位
postage	/'pəustidʒ/	n.邮费,邮资
postcard	/ˈpəʊstkɑːd/	n.明信片
poster	/'pəustə/	n海报,张贴的大幅广告
postman	/'pəustmən/	n.邮递员
postpone	/pəust'pəun,pə'sp-/	v.推迟,延期
posture	/'pɔstʃə/	n.姿势,姿态,心态,态度v.作出某种姿势
pot	/pɔt/	n.罐,壶
potato	/pə'teitəu/	n.马铃薯,土豆
potential	/pəu'tenʃəl/	a.潜在的,可能的n.潜能,潜力
poultry	/'pəultri/	n.家禽
pound	/paund/	n.磅;英镑v.(连续)猛击,(猛烈)敲打,捣碎
pour	/pɔ:/	v.灌注,倾泻,涌入,流,倾盆大雨
poverty	/'pɔvəti/	n.贫穷,贫困
powder	/'paudə/	n.粉末,药粉;火药,炸药
power	/pauə/	n.力,精力;功率,电力;(数学)幂;权力,势力
powerful	/'pauəful/	a.强大的,有力的,有权的
practical	/'præktikəl/	a.实际的,实用的
practically	/'præktikəli/	ad.几乎,实际上,简直
practice	/'præktis/	n.练习,实践,实际,业务,惯例,习惯
practise	/'præktis/	v.练习,实习,实践,实行,使...练习,训练
practitioner	/præk'tiʃənə/	n.实践者,从事者;(医生或律师等)开业者
praise	/preiz/	v.赞扬,歌颂;表扬n.称赞,赞美;赞美的话
pray	/prei/	v.请求,恳求;祈祷,祈求
prayer	/preə/	n.祈祷,祷告,祷文
preach	/pri:tʃ/	v.宣讲(教义),布道;竭力鼓吹,宣传;说教
precaution	/pri'kɔ:ʃən/	n.预防,谨慎,警惕
precede	/pri:'si:d,pri-/	v.领先(于),在(…之前);优先,先于
precedent	/pri'si:dənt,'presi-/	n.先例
preceding	/pri'si:diŋ,'pri:-/	a.在前的,在先的
precious	/'preʃəs/	a.珍贵的,贵重的
precise	/pri'sais/	a.精确的,准确的
precision	/pri'siʒən/	n.精确,精确度
preclude	/pri'klu:d/	v.排除,阻止,妨碍
predecessor	/'pri:disesə,'pre-/	n.前辈,前任
predict	/pri'dikt/	v.预言,预测,预告
predominant	/,pri'dɔminənt/	a.(over)占优势的;主要的,突出的
preface	/'prefis/	n.序言,引言,前言v.作序,写前言
prefer	/pri'fə:/	v.(to)更喜欢,宁愿
preferable	/'prefərəbl/	a.(to)更可取的,更好的
preference	/'prefərəns/	n.(for,to)偏爱,喜爱;优惠;优先选择
pregnant	/'preɡnənt/	a.怀孕的,孕育的,充满的,意味深长的
prejudice	/'predʒudis/	n.偏见,成见;损害,侵害v.使抱偏见,损害
preliminary	/pri'liminəri/	a.预备的,初步的
premier	/'premjə,pri'miə/	n.首相,总理
premise	/pri'maiz,'premis/	n.前提,房屋连地基v.提论,预述,假定
premium	/'pri:miəm/	n.额外费用,奖金,奖赏,保险费
preparation	/,prepə'reiʃən/	n.准备,预备;制剂,制备品
prepare	/pri'pεə/	v.准备,预备
preposition	/,prepə'ziʃən/	n.介词
prescribe	/pris'kraib/	v.指示,规定;处(方),开(药)
prescription	/pris'kripʃən/	n.药方,处方
presence	/'prezəns/	n.出席,到场,存在,在
present	/'prezənt,pri'zent/	a.出席的,现在的n.现在,礼物v.赠送,提出
presently	/'prezəntli/	ad.一会儿,不久;现在,目前
preserve	/pri'zə:v/	v.保护,维持;保存,保藏
preside	/pri'zaid/	v.(at,over)主持
president	/'prezidənt/	n.总统,校长,会长,主席
press	/pres/	v.压;压榨;紧迫,催促n.报刊,通讯社;压榨机
pressure	/'preʃə/	n.压,压力,压迫,强制,紧迫,困苦,困难
prestige	/pre'sti:ʒ/	n.声望,威望,威信
presumably	/pri'zju:-məbli,pri:-/	ad.推测起来,大概
presume	/pri'zju:m,-'zu:m/	v.假定,假设,认为,揣测,滥用,擅自行动
pretend	/pri'tend,pri:-/	v.假装,假托,借口,(在演戏中)装扮
pretext	/'pri:tekst/	n.借口,托词
pretty	/'priti/	ad.相当,很a.漂亮的,俊俏的,标致的
prevail	/pri'veil,pri:-/	v.(over,against)取胜,占优势;流行,盛行
prevalent	/'prevələnt/	a.流行的,普遍的
prevent	/pri'vent,pri:-/	v.(from)预防,防止,阻止,制止,妨碍
previous	/'pri:vjəs/	a.先前的,以前的
prey	/prei/	n.被掠食者,牺牲者,掠食v.捕食,掠夺,折磨
price	/prais/	n.价格,价钱;代价v.标价
prick	/prik/	n./v.刺伤,刺痛,刺孔
pride	/praid/	n.自豪;自满;引以自豪的东西v.使自豪
priest	/pri:st/	n.教士,神父
primary	/'praiməri/	a.最初的,初级的;首要的,主要的,基本的
prime	/praim/	a.首要的;最好的,第一流的n.青春,全盛期
primitive	/'primitiv/	a.原始的,远古的,早期的;粗糙的,简单的
prince	/prins/	n.王子,亲王
princess	/prin'ses,'prinsis/	n.公主,王妃
principal	/'prinsəpəl/	a.最重要的,主要的n.负责人,校长;资本,本金
principle	/'prinsəpl/	n.原理,原则;主义,信念
print	/print/	n.印刷,印刷品,字体v.印刷,出版;洗印
prior	/'praiə/	a.优先的,在前的;(to)在…之前
priority	/prai'ɔrəti/	n.先,前;优先,重点,优先权
prison	/'prizən/	n.监狱
prisoner	/'prizənə/	n.囚犯
privacy	/'praivəsi,'pri-'prai-/	n.(不受干扰的)独处,自由,隐私;私生活
private	/'praivit/	a.私人的,个人的,秘密的,私下的
privilege	/'privilidʒ/	n.特权,优惠,特许v.给予优惠,给予特权
prize	/praiz/	n.奖赏,奖金,奖品v.珍视,珍惜
probability	/,prɔbə'biləti/	n.可能性,或然性,概率
probable	/'prɔbəbl/	a.很可能的,大概的;有希望的,可能的
probe	/prəub/	n.探针,探测器v.(以探针等)探查,穿刺,查究
problem	/'prɔbləm/	n.问题,疑难问题;思考题,讨论题
procedure	/prə'si:dʒə/	n.程序,手续,步骤
proceed	/prəu'si:d/	v.进行,继续下去;发生
proceeding	/prəu'si:diŋ/	n.行动,进行,(pl.)会议录,学报
process	/'prəuses,'prɔ-/	n.过程,进程;工序,制作法;工艺v.加工,处理
procession	/prəu'seʃən/	n.队伍,行列
proclaim	/prəu'kleim/	v.宣告,声明
produce	/prəu'dju:s,'prɔdju:s/	v.生产,制造,显示,演出,导致n.产品
product	/'prɔdəkt,-ʌkt/	n.产品,产物;乘积
production	/prəu'dʌkʃən/	n.生产,产品,作品,(研究)成果,总产量
productive	/prəu'dʌktiv/	a.生产(性)的,能产的,多产的
productivity	/,prɔdʌk'tivəti,,prəu-/	n.生产率
profession	/prəu'feʃən/	n.职业,专业,表白,宣布
professional	/prəu'feʃənəl/	a.职业的,专门的n.自由职业者,专业人员
professor	/prəu'fesə/	n.教授
proficiency	/prəu'fiʃənsi/	n.(in)熟练,精通
profile	/'prəufail/	n.侧面(像);轮廓,外形;人物简介
profit	/'prɔfit/	n.利润,收益v.(by,from)得利,获益;有利于
profitable	/'prɔfitəbl/	a.有利可图的,有益的
profound	/prəu'faund/	a.深刻的,意义深远的;渊博的,造诣深的
programme	/'prəuɡræm,-ɡrəm/	n.(program)节目,计划,规划,程序v.编程序
progress	/'prəuɡres,prəu'ɡres/	v./n.进步,进展;前进
progressive	/prəu'ɡresiv/	a.进步的,先进的;前进的
prohibit	/prəu'hibit/	v.禁止,不准;阻止
project	/'prɔdʒekt,prə'dʒekt/	n.方案,工程,项目v.投射,放映;设计,规划
projector	/prəu'dʒektə/	n.放映机,幻灯机,投影仪
prolong	/prə'lɔŋ,'lɔ:ŋ/	v.拉长,延长,拖延
prominent	/'prɔminənt/	a.突起的,凸出的;突出的,杰出的
promise	/'prɔmis/	v.允许,答应;有…可能n.承诺;希望,出息
promising	/'prɔmisiŋ/	a.有希望的,有前途的
promote	/prəu'məut/	v.促进,发扬;提升,提拔;增进,助长
prompt	/prɔmpt/	a.敏捷的,迅速的,即刻的v.激起,促进,推动
prone	/prəun/	a.倾向于,俯伏的,倾斜的,陡的
pronoun	/'prəunaun/	n.代词
pronounce	/prəu'nauns/	v.发…的音;宣布,宣判
pronunciation	/prəu,nʌnsi'eiʃən/	n.发音,发音方法
proof	/pru:f/	n.证据,证明;校样,样张
propaganda	/,prɔpə'ɡændə/	n.宣传(机构);/天主教/传道总会
propel	/prəu'pel/	vt.推进,推动;激励,驱使
proper	/'prɔpə/	a.适合的;合乎体统的;固有的;有礼貌的
property	/'prɔpəti/	n.财产,资产,地产,房地产,所有物;性质,特性
prophet	/'prɔfit/	n.预言家;先知;提倡者
proportion	/prəu'pɔ:ʃən/	n.比例;部分;均衡,相称
proposal	/prəu'pəuzəl/	n.提议,建议;求婚
propose	/prəu'pəuz/	v.提议,建议;提名,推荐;求婚
proposition	/,prɔpə'ziʃən/	n.主张,建议;陈述,命题
prose	/prəuz/	n.散文a.散文的
prosecute	/'prɔsikju:t/	vt.实行,从事v.起诉,告发vi.作检察官
prospect	/'prɔspekt/	n.景色;前景,前途,展望
prospective	/prəu'spektiv/	a.预期的
prosper	/'prɔspə/	v.成功,兴隆,昌盛,使成功,使昌隆,繁荣
prosperity	/prɔs'periti/	n.繁荣,兴旺
prosperous	/'prɔspərəs/	a.繁荣的,兴旺的,茂盛的,顺利的
protect	/prəu'tekt/	v.(from)保护,保卫
protein	/'prəuti:n,-ti:in/	n.蛋白质
protest	/prəu'test,'prəu-/	v./n.主张,断言,抗议,反对
prototype	/'prəutətaip/	n.原型;典型,范例
proud	/praud/	a.(of)自豪的;引以自豪的;妄自尊大的
prove	/pru:v/	v.证明,证实;检验;考验;鉴定;结果是,表明是
provide	/prəu'vaid/	v.供应,供给,准备,预防,规定
provided	/prəˈvaɪdɪd/	conj.倘若,只要,假如
province	/'prɔvins/	n.省;领域,范围,本分
provision	/prəu'viʒən/	n.供应,(一批)供应品;预备;条款;(pl.)给养
provoke	/prəu'vəuk/	v.挑动;激发;招惹
prudent	/'pru:dənt/	a.谨慎的,智慧的,稳健的,节俭的
psychiatry	/psai'kaiətri,psi-/	n.精神病学,精神病疗法
psychology	/psai'kɔlədʒi/	n.心理,心理学,心理状态
pub	/pʌb/	n.(英国)小酒店;小旅馆
public	/'pʌblik/	a.公共的,公用的;公开的,公然的n.公众,民众
publication	/,pʌbli'keiʃən/	n.出版物;出版,发行;公布,发表
publicity	/pʌb'lisiti/	n.公开,宣传,广告,推销
publish	/'pʌbliʃ/	v.出版,刊印;公布,发布
puff	/pʌf/	n.一阵,一股(气味等);喘息;吹嘘v.喘息,鼓吹
pull	/pul/	v.拉,拖n.拉,拖;拉力,牵引力
pulse	/pʌls/	n.脉搏,脉冲
pump	/pʌmp/	n.泵v.用(泵)抽(水);打气,泵送
punch	/pʌntʃ/	n.冲压机,冲床;穿孔机v.冲压,穿孔
punctual	/'pʌŋktjuəl,-tʃuəl/	a.严守时刻的,准时的,正点的
punish	/'pʌniʃ/	v.惩罚,处罚
pupil	/'pjupəl/	n.学生,小学生;瞳孔
puppet	/'pʌpit/	n.木偶,傀儡
purchase	/'pə:tʃəs/	v.买,购买n.购买的物品
pure	/pjuə/	a.纯的,纯洁的;纯理论的,抽象的;完全的
purify	/'pjuərifai/	v.使纯净,提纯
purple	/'pə:pl/	a.紫的n.紫色
purpose	/'pə:pəs/	n.目的,意图;用途,效果
purse	/pə:s/	n.钱包
pursue	/pə'sju:,-'su:/	v.追赶,追踪;继续,从事
pursuit	/pə'sju:t/	n.追赶,追求;职业,工作
push	/puʃ/	v.推;催逼,逼迫n.推,推力;促进,推进
put	/put/	vt.放,搁,置;表达;使处于...状态,记下
puzzle	/'pʌzl/	n.难题,谜,迷惑v.(使)迷惑,(使)为难
pyramid	/'pirəmid/	n.金字塔
qualification	/,kwɔlifi'keiʃən/	n.资格,合格;限定,条件;合格证
qualify	/'kwɔlifai/	v.(使)具有资格,证明合格;限制,限定;修饰
qualitative	/'kwɔlitətiv,-tei-/	a.性质上的,定性的
quality	/'kwɔləti/	n.质量,品质,特性
quantify	/'kwɔntifai/	v.确定数量
quantitative	/'kwɔntitətiv,-tei-/	a.数量的,定量的
quantity	/'kwɔntəti/	n.量,数量;大量
quarrel	/'kwɔ:rəl/	v.争吵,争论n.争吵,争吵的原因
quart	/kwɔ:t/	n.夸脱
quarter	/'kwɔ:tə/	n.四分之一;季;一刻钟;(pl.)方向;(pl.)住处
quarterly	/'kwɔ:təli/	a.每季的ad.每季一次n.季刊
quartz	/kwɔ:ts/	n.石英
queen	/kwi:n/	n.女王,皇后,王后
queer	/kwiə/	a.奇怪的,古怪的
quench	/kwentʃ/	v.熄灭,扑灭,压制,抑制,止渴
quest	/kwest/	n.探寻,探求;寻求,追求
question	/'kwestʃən/	n.问题;询问v.询问;怀疑,对…表示疑问
questionnaire	/,kwestʃə'nεə,,kes-/	n.调查表,问卷
queue	/kju:/	n.行列,长队v.(up)排队,排队等待
quick	/kwik/	a.快的;灵敏的,伶俐的;敏锐的ad.快,迅速地
quiet	/'kwaiət/	a.安静的,平静的n.安静v.使安静,平静
quilt	/kwilt/	n.被子
quit	/kwit/	v.离开,退出;停止,放弃,辞职
quite	/kwait/	ad.十分,完全;相当,颇;的确,真正
quiver	/'kwivə/	v./n.颤抖,抖动
quiz	/kwiz/	n.小型考试,测验,问答比赛
quota	/'kwəutə/	n.(生产、进出口等的)配额,(移民的)限额
quote	/kwəut,kəut/	v.引用,援引
rabbit	/'ræbit/	n.兔子
race	/reis/	n.赛跑;人种,种族;属,种v.赛跑
racial	/'reiʃəl/	a.种的,种族的
rack	/ræk/	n.挂物架,搁物架v.使痛苦,折磨
racket	/'rækit/	n.球拍
radar	/'reidə/	n.雷达
radiant	/'reidiənt/	a.发光的,辐射的,容光焕发的
radiate	/'reidieit/	v.放射,辐射;散布,传播
radical	/'rædikəl/	a.基本的,重要的;激进的,极端的;根本的
radio	/'reidiəu/	n.收音机;无线电报,无线电话v.无线电通讯
radioactive	/,reidiəu'æktiv/	a.放射性,放射引起的
radius	/'reidiəs/	n.半径,半径范围,有效航程,范围,界限
rag	/ræɡ/	n.抹布,破布,碎布
rage	/reidʒ/	n.愤怒
raid	/reid/	n/v..袭击,搜查
rail	/reil/	n.栏杆,围栏;(pl.)铁路;铁轨;横杆,栏杆
railroad	/'reilrəud/	n.(railway)铁路v.由铁道运输
rain	/rein/	n.雨;雨天;下雨vi.下雨vt.使大量落下
rainbow	/'reinbəu/	n.虹
raise	/reiz/	v.举起,提升;增加;饲养;引起;竖起;提出
rake	/reik/	n.耙子,耙机v.耙;搜索,探索
rally	/'ræli/	v.重整,恢复,振作n.聚集,集会,拉力赛
random	/'rændəm/	a.随机的,随意的n.随机,随意
range	/reindʒ/	n.范围,领域;排列,连续;(山)脉v.排列成行
rank	/ræŋk/	n.军衔,社会阶层;排v.分等级,把…分类
rap	/ræp/	n.叩击,轻拍,斥责v.敲,拍,打,斥责,使着迷
rape	/reip/	n./vt.掠夺,蹂躏,强奸
rapid	/'ræpid/	a.快,急速的n.(pl.)急流,湍滩
rare	/rεə/	a.稀有的,难得的,珍奇的;稀薄的,稀疏的
rarely	/'rεəli/	ad.很少,难得,非常地
rash	/ræʃ/	a.轻率的,鲁莽的n.皮疹
rat	/ræt/	n.鼠
rate	/reit/	n.速率;等级;价格,费用v.估价;评级,评价
rather	/'rɑ:ðə,'ræ-/	ad.相当,有一点儿;宁愿,宁可
ratio	/'reiʃiəu,-ʃəu/	n.比,比率
rational	/'ræʃənəl/	a.理性的,合理的
raw	/rɔ:/	a.未煮过的,生的;未加工过的,未经训练的
ray	/rei/	n.光线,射线
razor	/'reizə/	n.剃刀
reach	/ri:tʃ/	v.抵达;(out)伸手,够到n.能达到的范围
react	/ri'ækt,ri:-/	v.反应,起作用;(against)反对,起反作用
read	/ri:d/	v.朗读;阅读vt.辨认,观察vi.读到,获悉
reader	/'ri:də/	n.读者;读本,读物;(英国的)大学讲师
readily	/'redili/	ad.容易地;乐意地,欣然地
reading	/'ri:diŋ/	n.读书,读物,(仪表等的)读数,阅读
ready	/'redi/	a.(for)准备好的,现成的;甘心的
real	/'riəl,ri:l/	a.真的,真实的;实际的,现实的
realise	/'riəlaiz,'ri:-/	v.(realize)认识到,体会到;实现
realistic	/,riə'listik,,ri:-/	a.现实(主义)的
reality	/ri'æləti,ri:-/	n.现实,实际;真实
really	/'riəli,'ri:li/	ad.确实,实在,真正地,果然
realm	/relm/	n.王国,国土;领域
reap	/ri:p/	v.收割,收获
rear	/riə/	n.后面,背后,后方v.饲养,抚养,栽培,举起
reason	/'ri:zən/	n.原因,理性,理智v.推理,说服,辩论,讨论
reasonable	/'ri:zənəbl/	a.合理的,有道理的;通情达理的;适度的
reassure	/,ri:ə'ʃuə/	v.使安心,使放心;使消除疑虑
rebel	/'rebəl,ri'bel/	v.反抗,反叛,起义n.叛逆者,起义者
rebellion	/ri'beljən/	n.叛乱,反抗,起义
recall	/ri'kɔ:l,'ri:kɔ:l/	v.回忆,回想;撤消,收回
recede	/ri'si:d/	v.退回,后退;收回,撤回;跌落,缩减,贬值
receipt	/ri'si:t/	n.收据,收条;收到,接到
receive	/ri'si:v/	v.收到,接到;遭受,受到;接待,接见
recent	/'ri:sənt/	a.新近的,近来的
reception	/ri'sepʃən/	n.接待,招待会;接收,接受,接收效果
recipe	/'resipi/	n.烹饪法,食谱;诀窍,方法
recipient	/ri'sipiənt/	a.接受的,感受性强的n.接受者,感受者,容器
reciprocal	/ri'siprəkəl/	a.相互的,往复的,互利的
recite	/ri'sait/	v.背诵,朗诵
reckless	/'reklis/	a.不注意的,大意的,卤莽的,不顾后果的
reckon	/'rekən/	v.计算,总计,估计,猜想,依赖
reclaim	/ri'kleim/	v.要求归还,收回;开垦
recognition	/,rekəg'niʃən/	n.认出,辨认;承认
recognize	/'rekəɡnaiz/	v.(recognise)认出,承认,公认,赏识,表扬
recollect	/,rekə'lekt/	v.回忆,想起,记起,忆起,记得
recommend	/,rekə'mend/	v.推荐,介绍;劝告,建议
reconcile	/'rekənsail/	v.使和好,调解,使调和;(to,with)使一致
record	/ri'kɔ:d,'rekɔ:d/	n.记录;最高记录;履历;唱片v.记录;录音
recorder	/ri'kɔ:də/	n.记录员;录音机
recover	/ri'kʌvə/	v.收回;(from)恢复,痊愈;重新获得
recovery	/ri'kʌvəri/	n.痊愈,复元;重获,恢复
recreation	/,rekri'eiʃən,-kri:-/	n.娱乐,消遣
recruit	/ri'kru:t/	v.征募(新兵),吸收;补充n.新成员,新兵
rectangle	/'rek,tæŋɡl/	n./数/矩形,长方形
rectify	/'rektifai/	v.纠正,整顿,/化/精馏
recur	/ri'kə:/	v.(尤指不好的事)一再发生;重现
recycle	/,ri:'saikl/	v./n.再循环,重复利用
red	/red/	a.红的,红色的n.红色;红色颜料
reduce	/ri'dju:s,-'du:s/	v.减少,缩小;简化,还原
reduction	/ri'dʌkʃən/	n.减小,减少,缩小
redundant	/ri'dʌndənt/	a.多余的,过剩的;(食物)丰富的;被解雇的
reed	/ri:d/	n.芦苇,苇丛;芦笛,牧笛
reel	/ri:l,riəl/	n.卷筒,线轴v.卷,绕
refer	/ri'fə:/	v.参考,查询;提到,引用,涉及;提交,上呈
reference	/'refərəns/	n.提及,涉及;参考,参考书目;证明书（人）
refine	/ri'fain/	v.精炼,精制,提纯;使文雅,使高尚
reflect	/ri'flekt/	v.反射,反映,表现,反省,沉思
reflection	/re'flekʃən/	n.(reflexion)映像,倒影;反省,沉思
reform	/ri'fɔ:m/	v./n.改革,改造,改良
refrain	/,ri:'frein/	v.节制,避免,制止n.(诗的)叠句
refresh	/ri'freʃ,ri:-/	v.(使)精神振作,(使)精力恢复
refreshment	/ri'freʃmənt,ri:-/	n.(pl.)点心,饮料;精力恢复,爽快
refuge	/'refju:dʒ/	n.避难处,藏身处
refugee	/,refju'dʒi:,'refjudʒi:/	n.(政治上的)避难者,难民
refund	/ri'fʌnd/	n.归还,偿还额,退款v.退还,偿还,偿付